....................................................................................................
....................................................................................................
....................................................................................................
....................................................................................................
....................................................................................................
....................................................................................................
............[][][][][][][][][][][][][][][][][][][][][][][][][][][][][][][][][][][][][][]............
............[]......................[]................................................[]............
............[]......................[]................................................[]............
............[]......................[]................................................[]............
............[]......................[]................................................[]............
............[]......................[]................................................[]............
............[]......................[]................................................[]............
............[]......................[]................................................[]............
............[]......................[]................................................[]............
............[]......................[]................................................[]............
............[]......................[]................................................[]............
............[]......................[]................................................[]............
............[]......................[]................................................[]............
............[]......................[]................................................[]............
............[]......................[]................................................[]............
............[]......................[]................................................[]............
............[]......................[]................................................[]............
............[]......................[]................................................[]............
............[]......................[]................................................[]............
............[]......................[]................................................[]............
............[]......................[]................................................[]............
............[]......................[]................................................[]............
............[]......................[]................................................[]............
............[]......................[]................................................[]............
............[]......................[]................................................[]............
............[]......................[]................................................[]............
............[]......................[]................................................[]............
............[]......................[]................................................[]............
............[][][][][][][][][][][][][][][][][][][][][][][][][][][][][][][][][][][][][][][][][][][][]
............[][][][][][][][][][][][][]................................................[]......[]....
............[]......................[]................................................[]......[]....
............[]......................[]................................................[]......[]....
............[]......................[]................................................[]......[]....
............[]......................[]................................................[]......[]....
............[]......................[]................................................[]......[]....
............[][][][][][][][][][][][][][][][][][][][][][][][][][][][][][][][][][][][][][][][][][]....
....................................................................................................
....................................................................................................
....................................................................................................
....................................................................................................
....................................................................................................
....................................................................................................
....................................................................................................
....................................................................................................
