. . . . . . . . . . 
[][]<><><><><>[][][]
[][]. <>. . . [][][]
. . . <>. . . . <>. 
. . . <>. . . . <>. 
. . [][][]. . . <>. 
. . [][][]. . . <>. 
. . . . . . . . <>. 
. . . . . . . . [][]
. . . . . . . . [][]
